

NO        ./path_to_the_north_texture   

SO          ./path_to_the_south_texture




WE 5555  

EA dsadasd

F   220,255,166

C        225,255,255

 1111111       11111111    1111111   1111111    1111111
1100000011        11       11        11        11N0000011
1100000011        11       11        11        1100000011
1111111111        11       1111111   1111111   1111111111
11      11        11            11        11   11      11
11      11        11            11        11   11      11
11      11     11111111    1111111   1111111   11      11
