NO        ./path_to_the_north_texture           
SO          ./path_to_the_south_texture
WE 5555  
EA dsadasd
F   220,255,166
C        225,255,0              

 1
101
1N1
 1

1111
1001
 11
  