

NO        ./path_to_the_north_texture   

SO          ./path_to_the_south_texture




WE 5555  

EA dsadasd

F   220,255,166

C        225,255,255
 


111111111111
1     1010101
1 1 1 1111 1
11111111111111
1         1N11
11111111111111
