C 225,255,0

SO ./algo.txt
EA ./algo.txt

WE ./algo.txt  






NO ./younes.txt                     



F 225,255,0








11111111111111111
10000000000000001
10000000000000001
10000000000000001
10000000000000001
10000000000000001
10000000E000000001
10000000000000001
10000000000000001
10000000000000001
10000000000000001
10000000000000001
10000000000000001
11111111111111111