SO  textures/wall_1.xpm
WE  textures/wall_2.xpm
EA  textures/wall_3.xpm
NO  textures/wall_4.xpm


F 135,206,235
C 139,90,43


 
11111111111
101110100001
10000000111
1001011111
1S0101
111111
101
11111