SO  textures/1.xpm
WE  textures/2.xpm
EA  textures/3.xpm
F 135,206,235
NO  textures/4.xpm


C 139,90,43



1111111111111111111111111
1000000000000000000000001
1000000000000000000000001
10000000000000N0000000001
1000000000000000000000001
1000000000000000000000001
1000000000000000000000001
1000000000000000000000001
1111111111111111111111111
1111111111111111111111111