NO ./path_to_the_north_texture
SO ./path_to_the_south_texture
WE ./path_to_the_west_texture
EA ./path_to_the_east_texture
F 220,100,0
C 225,30,0

        1111111111111111111111111
        1000000000110000000000001
        1011000001110011100000111
        100100000000001 100000001
111111111011000001110011100000001
100000000011000000000000100011111
11110111111111011100000010001111111111111111111111
11110111000111011101010010001000000000000000000001
11110111000111011101010010000000001111111111111111
111100000000000000000000000000010010001      1
111100000000000000000000000001010010001      1
111100000000000001000000010101010010001      1
111100000000001000000000000001010010001      1
11110000000000000W000000011101010010001      1
111100000000000100000000000001010010001      1
111100000000000000000000011101010010001      1
111100000000000000000000001001010010001      1
1111000000000000000000000000010100100011     1
11110000111111011101010010001111111111001    1
11000000110101011100000010001        11001   1
10000000000000001100000010001         10001  1
10000000000000001101010010001         100001 1
1100000111010101111101111000111111111110000011
11110111 1110101 10111101000000000000000000001
11111111 1111111 11111111111111111111111111111
11111111 1111111 11111111111111111111111111111
