SO  textures/1.xpm
WE  textures/119.xpm
EA  textures/3.xpm
NO  textures/4.xpm


F 135,206,235
C 139,90,43


 
11111111111
10N110100001
10010111111
1001011111
100101
11111
101
11111
