NO ./algo.txt          
EA ./algo.txt
SO          ./algo.txt
WE ./algo.txt  
C 225,255,0              
F 220,255,166
        1111111111111111111111111
        100000000010000000000001
        1011000001110011100000111
        100100000000001 100000001
111111111011000001110011100000001
100000000011000000000000100011111
11110111111111011100000010001111111111111111111111
11110111000111011101010010001000000000000000000001
11110111000111011101010010000000001111111111111111
111100000000000000000000000000010010001      1
111100000000000000000000000001010010001      1
111100000000000000000000010101010010001      1
111100000000000000000000000001010010001      1
111100000000000000000000011101010010001      1
111100000000000000000000000001010010001      1

111100000000000000000000011101010010001      1
11110000000000000000000001001010010001      1
1111000000000000000000000000010100100011     1
11110000111111011101010010001111111111001    1
11000000110101011100000010001        11001   1
10000000000000001100000010001         10001  1
10000000000000001101010010001         100001 1
11000001110101011111011110N0111111111110000011
11110111 1110101 10111101000000000000000000001
11111111 1111111 11111111111111111111111111111
11111111 1111111 11111111111111111111111111111

