NO ./path_to_the_north_texture
SO ./path_to_the_south_texture
WE ./path_to_the_west_texture
EA ./path_to_the_east_texture
F 220,100,0
C 225,30,0
11111111111111111111111111111111
10000000000000000000000000000001
10000000000000000000000000000001
10000000011100000000111000000001
10000000000000000000000000000001
10000000000000000000000000000001
10000000011111111111111100000001
10000000000000010000000000000001
100000000000001E1000000000000001
10000000000000010000000000000001
11111111111111111111111111111111
            111111
            111111
11          111111           11
1111111111111111111111111111111
            111111
            111111
            111111
            111111
            111111
            111111
           111  111
          111    111
          111    111
          111    111
          111    111