SO  textures/1.xpm
WE  textures/119.xpm
EA  textures/3.xpm
NO  textures/4.xpm


F 135,206,235
C 139,90,43



111111
100001
100101
100S01
111111
