SO  textures/wall_1.xpm
WE  textures/wall_2.xpm
EA  textures/wall_3.xpm
NO  textures/wall_4.xpm


F 50,56,55
C 55,90,190

11111111111
11111111111
10000000001
10000000001
10000000001
10000000001
10000000001
10000000001
1000000001
10000000001
10000000001
10000000001
10000000001
1000S000001
10000000001
10000000001
10000000001
10000000001
10000000001
10000000001
10000000001
10000000001
10000000001
10000000001
10000000001
10000000001
10000000001
10000000001
10000000001
10000000001
10000000001
10000000001
10000000001
11111111111
